AARON	EH R AH N
ABDON	AE B D AH N
ABDONIE	AE B D OW N AY
ABEL	EY B AH L
ABELIN	AH B EH L IH N
ABELINE	AH B IH L AY N
ABIGAELLE	AE B AH G IY L
ABIGAïL	AH B AY G AE L
ABONDANCE	AH B AA N D AH N S
ABRAHAM	EY B R AH HH AE M
ABSALON	AE B S AH L AH N
ABéLARD	AE B L AH R D
ACACE	AE K AH S
ACACIE	AH K EY S AY
ACANTHE	AE K AH N DH
ACHAIRE	AE CH AH AH R
ACHILLE	AH K IH L IY
ADALARD	AE D AH L AH R D
ADALBALD	AH D AE L B AH L D
ADALBAUDE	AH D AE L B AH D
ADALBERT	AH D AE L B AH R T
ADALBéRON	AH D AE L B R AH N
ADALRIC	AE D AH L R AH K
ADALSINDE	AH D AE L S AH N D
ADAM	AE D AH M
ADEGRIN	AH D IY G R IH N
ADEGRINE	AE D AH G R AY N
ADEL	AH D EH L
ADELIN	AE D AH L AH N
ADELINE	AE D AH L AY N
ADELPHE	AE D AH L F
ADELTRUDE	AE D AH L T R UW D
ADENET	AH D IY N EH T
ADHéMAR	AE D HH M AH R
ADJUTOR	AE JH Y UW T AH R
ADOLPHE	AH D OW L F
ADOLPHIE	AH D OW L F AY
ADONIS	AH D AA N AH S
ADONISE	AE D AH N AY Z
ADRASTéE	AE D R EY S T
ADREHILDE	AE D R AH HH AH L D
ADRIEN	AH D R AY AH N
ADRIENNE	AA D R IY EH N
ADèLE	AE D AH L
ADéLAïDE	AE D L EY D
ADéLIE	AE D L AY
ADéODAT	AE D AH D AH T
AGAPET	AE G AH P AH T
AGATHANGE	AE G AH TH AH N JH
AGATHE	AH G EY DH
AGATHON	AE G AH TH AH N
AGILBERT	AH G IH L P ER T
AGILBERTE	AH JH IH L B AH R T
AGLAé	AE G L AH
AGNAN	AE G N AH N
AGNANE	AE G N EY N
AGNEFLèTE	AE G N AH F L T
AGNèS	AE N Z
AGRIPPIN	AH G R IH P IH N
AGRIPPINE	AH G R IH P AY N
AIMABLE	EY M AH B AH L
AIMé	EY M
AIMéE	EY M
ALAIN	AH L EY N
ALAINE	AH L EY N
ALAïS1	EY EH L EY EH S W AH N
ALBAN	AA L B AH N
ALBANE	AE L B EY N
ALBERT	AE L B ER T
ALBERTE	AE L B AH R T
ALBéRADE	AE L B R EY D
ALBéRIC	AE L B R AH K
ALCIBIADE	AE L S IH B IY EY D
ALCIDE	AE L S AY D
ALCIDIE	AE L S AH D AY
ALCIME	AE L S AY M
ALCINE	AE L S AY N
ALCYONE	AE L S AY OW N
ALDEGONDE	AE L D AH G AH N D
ALDONCE	AE L D AH N S
ALDRIC	AE L D R IH K
ALDRIC(2)	AO L D R IH K
ALEAUME	EY L IY UW M
ALETH	EY L IH TH
ALEXANDRE	AE L IH K S AA N D ER
ALEXANDRINE	AE L AH G Z AE N D R IY N
ALEXINE	AH L EH K S AY N
ALEXIS	AH L EH K S IH S
ALICE	AE L IH S
ALIETTE	AH L AY EH T
ALINE	AH L AY N
ALIX	AE L IH K S
ALIZé	AE L AH Z
ALIéNOR	AH L AY N ER
ALLIAUME:	AE L IY AH M
ALMINE	AE L M AY N
ALMIRE	AE L M AY R
ALOYSE	AH L OY S
ALOïS	AE L AH Z
ALOïSE	AH L UW Z
ALPHONSE	AE L F AA N Z
ALPHONSINE	AH L F AA N S IY N
ALPHéE	AE L F
ALPINIEN	AE L P IH N IY AH N
ALTHéE	AE L DH
ALVERèDE	AE L V AH R D
AMALIANE	AH M EY L IY EY N
AMALRIC	AE M AH L R AH K
AMALTHéE	AE M AH L DH
AMANDE	AE M AH N D
AMANDIN	AH M AE N D IH N
AMANDINE	AH M AE N D AY N
AMANT	EY M AH N T
AMANTE	AA M AA N T IY
AMARANDE	AE M AH R AH N D
AMARANTHE	AE M AH R AH N DH
AMARYLLIS	AE M ER IH L IH S
AMBRE	AE M B AH R
AMBROISE	AE M B R OY Z
AMBROISIE	AE M B R OY S AY
AMELINE	AA M EH L IY N IY
AMIEL	EY M IY L
AMINTE	AE M AH N T
AMOUR	AA M UW R
AMéDéE	AE M D
AMéLIANE	AE M L IY EY N
AMéLIE	AE M L AY
AMéLIEN	AE M L IY AH N
AMéTHYSTE	AE M TH AH S T
ANASTASE	AE N AH S T EY Z
ANASTASIE	AE N AH S T EY S AY
ANATOLE	AE N AH T OW L
ANATOLIE	AE N AH T OW L AY
ANAëL	EY N AH L
ANAëLLE	AE N AH L
ANAïS	AE N AH Z
ANCELIN	AE N S AH L AH N
ANCELINE	AE N S AH L AY N
ANDOCHE	AE N D AH CH
ANDRé	AE N D R
ANDRéE	AE N D AH R
ANDéOL	AE N D AH L
ANGADRêME	AE N G AH D R M
ANGE	EY N JH
ANGELINE	EY NG G IH L AY N
ANGELINE(2)	AE N JH IH L IY N
ANGILBE	AE N JH AH L B
ANGILBERTE	AE N JH IH L B AH R T
ANGILRAN	AE N JH IH L R AH N
ANGOUSTAN	AE N G AW S T AH N
ANGèLE	AE NG G AH L
ANGéLIQUE	AE N G L AH K
ANICET	AE N AH S AH T
ANICETTE	AH N AY S EH T
ANICéE	AH N AY S
ANNABELLE	AE N AH B AH L
ANNE	AE N
ANNETTE	AH N EH T
ANNIBAL	AE N AH B AH L
ANNONCIADE,	AE N AA N S IY EY D
ANSBERT	AE N S B AH R T
ANSBERTE	AE N S B AH R T
ANSELME	AE N S AH L M
ANSTRUDIE	AE N S T R UW D AY
ANTHELME	AE N TH AH L M
ANTHELMETTE	AE N T HH EH L M EH T
ANTIDE	AE N T AH D IY
ANTIGONE	AE T IH G AH N IY
ANTOINE	AA N T W AA N
ANTOINETTE	AE N T W AH N EH T
ANTONIN	AE N T AH N IH N
ANTONINE	AE N T AH N AY N
ANéMONE	AE N M OW N
APHéLIE	AE F L AY
APOLLINAIRE	AH P OW L IH N AH AY ER
APOLLINE	AE P AH L AY N
AQUILIN	AE K W AH L AH N
AQUILINE	AE K W AH L AY N
ARABELLE	AE R AH B AH L
ARCADE	AA R K EY D
ARCADIE	AA R K EY D IY
ARCHAMBAUD	AA R K AE M B AH D
ARCHANGE	AA R K AH N JH
ARCHIBALD	AA R CH AH B AO L D
ARGINE	AA R JH AY N
ARIAN	AE R IY AH N
ARIANE	EH R IY AE N
ARICIE	AH R AY S IY
ARIEL	EH R IY AH L
ARIELLE	AH R IY L
ARISTE	AH R AY S T
ARISTIDE	AA R IH S T IY D
ARLETTE	AA R L EH T
ARMANCE	AA R M AH N S
ARMAND	AA R M AA N D
ARMANDE	AA R M AH N D
ARMANDINE	AA R M AH N D AY N
ARMEL	AA R M EH L
ARMELINE	AA R M AH L AY N
ARMELLE	AA R M AH L
ARMIDE	AA R M AY D
ARMIN	AA R M AH N
ARMINE	AA R M IY N IY
ARNAUD,	AA R N AH D
ARNAUDE	AA R N AH D
ARNOULD,	AA R N OW L D
AROLDE	AH R OW L D
ARSINOé	AA R S AH N OW
ARSèNE	AA R S N
ARSèNIE	AA R S N AY
ARTHAUD	AA R TH AH D
ARTHUR	AA R TH ER
ARTHURINE	AA R TH AH R AY N
ARTHèME	AA R TH M
ARTéMIS	AA R T M AH S
ASCELIN	AE S AH L AH N
ASCELINE	AE S AH L AY N
ASCENSION	AH S EH N SH AH N
ASSOMPTION	AE S AA M P AH N
ASTARTé	AH S T AA R T
ASTRIDE	AH S T R AY D
ASTRéE	AE S T AH R
ASTéRIE	AE S T R AY
ATHALIE	AH TH EY L AY
ATHANASE	AE TH AH N EY Z
ATHANASIE	AE TH AH N EY S AY
ATHINA	AE TH AH N AH
ATHéNAïS	AE TH N AH Z
AUBE	AO B
AUBERTINE	AO B AH R T AY N
AUBRY	AO B R IY
AUDE	AO D
AUDEBERT	AO D AH B AH R T
AUDELINE	AO D AH L AY N
AUDOUIN	AO D AW AH N
AUDRAN	AO D R AH N
AUDREY	AO D R IY
AUGUSTE	AO G AH S T
AUGUSTINE	AA G AH S T IY N
AUGUSTINE(2)	AO G AH S T IY N
AURE	EY Y AH R
AURELLE	AO R AH L
AURIAN	EY Y UH R IY AH N
AURIANE	AO R IY EY N
AURORE	AO R AH R
AURèLE	AO R L
AURéLIE	AO R L AY
AURéLIENNE	AO R L IY N
AUXANE	AO K S EY N
AUXENCE	AO K S AH N S
AVELINE	AA V EH L IY N IY
AVIGAëLLE	AE V AH G AH L
AVOYE	AE V OY
AXEL	AE K S AH L
AXELINE	AE K S L AY N
AXELLE	AE K S AH L
AYMARD	EY M AH R D
AYMARDINE	EY M AH R D AY N
AYMERIC	EY M AH R AH K
AYMON	EY M AH N
AYMONDE	EY M AH N D
AZALéE	AH Z EY L
AZELINE	AE Z AH L AY N
AZéLIE	AE Z L AY
BALTHAZAR	B AE L TH AH Z ER
BAPTISTE	B AH P T IH S T
BARBE	B AA R B
BARNABé	B AA R N AE B
BARTHéLEMY	B AA R TH L AH M IY
BARTIMéE	B AA R T AY M
BASILE	B AA S AH L
BASILISSE	B AE S AH L AH S
BASTIEN	B AE S T AH N
BATHILDE	B AE TH AH L D
BAUDOUIN	B AO D UW IH N
BENJAMIN	B EH N JH AH M AH N
BENOîT	B AH N AA T
BERNADETTE	B ER N AH D EH T
BERNARD	B ER N AA R D
BERNARD(2)	B ER N ER D
BERTHE	B IH R DH IY
BERTILLE	B IH R T IH L
BERTRAND	B ER T R AH N D
BEUVE	B AH Y UW V IY
BLAISE	B L EY Z
BLANCHE	B L AE N CH
BLANDINE	B L AE N D AY N
BON	B AA N
BONIFACE	B AA N AH F AH S
BOUCHARD	B UW SH AA R D
BRICE	B R AY S
BRIEUC	B R Y UW K
BRIGITTE	B R IH JH IH T
BRUNEHAUT	B R UW N AH HH AH T
BRUNEHILDE	B R UW N AH HH AH L D
BRUNO	B R UW N OW
BéATRICE	B AE T R AY S
BéNIGNE	B N IH N
BéNéDICTE	B N D IH K T
BéRANGER	B R AE NG AH R
BéRANGèRE	B R AE N G AH R
BéRARD	B R AA R D
CALIXTE	K AE L AH K S T
CAMILLE	K AH M IY L
CAMILLIEN	K AE M IH L IY AH N
CAMéLIEN	K AE M L IY AH N
CANDIDE	K AE N D AY D
CAPUCINE	K AE P Y AH S AY N
CARIBERT	K AE R AH B AH R T
CARINE	K AA R IY N IY
CARLOMAN	K AA R L AH M AH N
CAROLINE	K EH R AH L AY N
CASSANDRE	K AE S AE N D AH R
CASSIEN	K AE S IY AH N
CATHERINE	K AE TH ER AH N
CATHERINE(2)	K AE TH ER IH N
CATHERINE(3)	K AE TH R IH N
CHANTAL	CH AE N T AH L
CHARLAINE	CH AA R L EY N
CHARLEMAGNE	SH AA R L AH M EY N
CHARLES	CH AA R L Z
CHARLES(2)	CH AA R AH L Z
CHARLINE	SH AA R L IY N
CHARLOTTE	SH AA R L AH T
CHILDEBERT	CH IH L D AH B AH R T
CHILPéRIC	CH IH L P R AH K
CHLOé	K L OW
CHRISTELLE	K R IH S T AH L
CHRISTIAN	K R IH S CH AH N
CHRISTIAN(2)	K R IH S CH IH N
CHRISTIANE	K R IH S T IY AA N
CHRISTINE	K R IH S T IY N
CHRISTODULE	K R IH S T AH D Y UW L
CHRISTOPHE	K R IH S T AO F
CHRYSOSTOME	K R IH S AH S T OW M
CHRéTIEN	K R T IY AH N
CLAIRE	K L EH R
CLARA	K L AE R AH
CLARA(2)	K L EH R AH
CLARENCE	K L EH R AH N S
CLARISSE	K L AE R IH S
CLARISSE(2)	K L AH R IY S
CLAUDE	K L AO D
CLAUDIEN	K L AO D IY AH N
CLAUDINE	K L AO D IY N
CLIO:	K L AY OW
CLOTAIRE	K L AA T AH AY ER
CLOTILDE	K L AA T AH L D
CLOVIS	K L OW V IH S
CLéANDRE	K L AE N D AH R
CLéMENCE	K L M EH N S
CLéMENT	K L M EH N T
CLéMENTINE	K L M EH N T AY N
COLIN	K OW L IH N
COLINE	K OW L IY N IY
CONCEPTION:	K AA N S EH P SH AH N
CONSTANCE	K AA N S T AH N S
CONSTANT	K AA N S T AH N T
CONSTANTIN	K AH N S T AE N T IH N
CORALIE	K AO R AH L IY
CORALINE	K AO R AH L AY N
CORENTIN	K OW R EH N T IH N
CORENTINE	K OW R AH N T AY N
CORINNE	K ER IY N
CYPRIEN	S IH P R IY AH N
CYRIAQUE	S IH R IY AH K
CYRIELLE	S AH R IY L
CYRILLE	S IH R AH L
CéCILE	K S AY L
CéDRIC	K D R IH K
CéLESTE	K L EH S T
CéLESTIN	K L EH S T AH N
CéLESTINE	K L EH S T AY N
CéLIEN	K L AY AH N
CéLINE	K L AY N
CéSAIRE	K S AE AH R
CéSAR	K S AA R
CôME	K M IY
DAMIEN	D EY M IY AH N
DANIEL	D AE N Y AH L
DANIELLE	D AE N IY EH L
DANIELLE(2)	D AE N Y EH L
DAPHNé	D AE F N
DAVID	D EY V IH D
DELPHIN	D IH L F IH N
DELPHINE	D EH L F IY N IY
DENIS	D EH N IH S
DENISE	D IH N IY S
DIANE	D AY AE N
DIDIER	D IH D IY ER
DIEUDONNé	D Y UW D AH N
DIEUDONNéE	D Y UW D AH N
DIMITRI	D IH M IY T R IY
DOMINIQUE	D AO M IH N IY K
DORIAN	D AO R IY AH N
DORIANE	D AO R IY EY N
DORINE	D AO R IY N IY
DOROTHéE	D AH R OW DH
DOUCE	D UW S
DOVE	D AH V
DOVE(2)	D OW V
DéBORA	D B AO R AH
DéSIRé	D S IH R
EDGARD	EH JH AH R D
EDMOND	EH D M AH N D
EDMéE	EH D M
ELLA	EH L AH
ELSA	EH L S AH
EMMA	EH M AH
EMMANUEL	IH M AE N Y UW AH L
EMMANUELLE	IH M AA N UW EH L
EMMELIE	IH M IY L AY
ERNEST	ER N AH S T
ERNEST(2)	ER N IH S T
ERNESTINE	ER N IH S T IY N
ESTELLE	EH S T EH L
ESTHER	EH S T ER
EUBERT	Y UW B AH R T
EUDES	Y UW D Z
EUDOXE	Y UW D AH K S
EUDOXIE	Y UW D AA K S AY
EUGèNE	Y UW N
EUGéNIE	Y UW G N AY
EULALIE	Y UW L EY L AY
EUPHRASIE	Y UW F R EY S AY
EUSTACHE	Y UW S T AH CH
EUSèBE	Y UW Z
EUSéBIE	Y UW Z AY
FABIEN	F AE B IY N
FABRICE	F AE B R AH S
FALBA	F AE L B AH
FANNY	F AE N IY
FANTINE	F AE N T AY N
FAUSTINE	F AW S T IY N
FERDINAND	F ER D IH N AE N D
FERDINAND(2)	F ER D IH N AE N
FERNANDE	F AH R N AH N D
FIACRE	F AY AH K AH R
FIDèLE	F AY D AH L
FIRMIN	F ER M IH N
FLAVIE	F L EY V AY
FLAVIEN	F L EY V IY AH N
FLEUR	F L ER
FLODOARD	F L AH D OW R D
FLORE	F L AO R
FLORENCE	F L AO R AH N S
FLORENT,	F L OW R AH N T
FLORIAN	F L AO R IY AH N
FLORIE	F L OW R IY
FORTUNé	F AO R T AH N
FORTUNéE	F AO R CH AH N
FOULQUES	F OW L K S
FRANCE	F R AE N S
FRANCIA	F R AA N CH AH
FRANCISQUE	F R AE N S AH S
FRANçOIS	F R AE N OW AH S
FRANçOISE	F R AH N OY Z
FRéDéRIC	F R D R IH K
FULBERT	F UH L B AH R T
FULCRAN	F UH L K R AH N
FULGENCE	F UH L JH AH N S
FéLICIE	F L IH S AY
FéLICITé	F L IH S AH T
FéLIX	F L IH K S
GABIN	G AE B IH N
GABRIEL	G EY B R IY AH L
GABRIELLE	G AA B R IY EH L
GARANCE	G AE R AH N S
GARNIER	G AA R N IY ER
GASPARD	G AH S P AA R D
GASTON	G AE S T AH N
GATIEN	G EY T Y EH N
GAUD	G AO D
GAUTIER	G AW T IY ER
GAëL	G AE L
GAëLLE	G AO L
GENEVIèVE	JH EH N AH V AH V
GEOFFROY	JH IY AH F R OY
GEORGES	JH AO R JH AH Z
GEORGES(2)	JH AO R JH IH Z
GEORGETTE	JH AO R JH EH T
GERBERGE	JH AH R B AH R JH
GERBERT	G ER B ER T
GERMAIN	JH ER M EY N
GERMAINE	ZH ER M EY N
GERTRUDE	G ER T R UW D
GERVAIS	ZH ER V EY
GHISLAIN	G IH Z L EY N
GILBERT	G IH L B ER T
GILLES	ZH IY L
GIRART	JH IH R AH R T
GISLEBERT	JH IH Z L AH B AH R T
GISèLE	JH AY Z AH L
GONDEBAUD	G AA N D AH B AH D
GONTHIER	G AA N TH AY AH R
GONTRAN	G AA N T R AH N
GONZAGUE	G AA N Z AH G
GRéGOIRE	G R G OY R
GUENIèVRE	G Y UW EH N AH V AH R
GUI	G UW
GUILHEMINE	G UW L HH AH M AY N
GUILLAUME	G IH L AW M
GUILLAUME(2)	G W IY L OW M
GUILLEMETTE	G IH L AH M EH T
GUSTAVE	G UW S T AA V IY
GUSTAVINE	G AH S T AH V AY N
GUY	G AY
GUYOT	G AY AH T
GUéRIN	G Y UH R AH N
GWENAëLLE	G W EH N AH L
GéDéON	G D AA N
GéRARD	G R AA R D
GéRAUD	G R AO D
HARDOUIN	HH AA R D AW AH N
HECTOR	HH EH K T ER
HENRI	HH EH N R IY
HENRI(2)	AO R IY
HENRI(3)	AA N R IY
HENRIETTE	HH EH N R IY EH T
HERBERT	HH ER B ER T
HERLUIN	HH AH R L UW N
HERMINE	HH ER M IH N
HERVé	HH AH R V
HILAIRE	HH IH L AH AH R
HILDEBERT	HH IH L D AH B AH R T
HINCMAR	HH IH NG K M AH R
HIPPOLYTE	HH IH P AH L AY T
HONORINE	HH AA N AH R AY N
HONORé	AA N ER
HORTENSE	HH AO R T AH N S
HUBERT	HH Y UW B ER T
HUGUES	HH Y UW G Z
HUGUETTE	HH Y UW G Y UW EH T
HéDELIN	HH D EH L AH N
HéLIER	HH L AY AH R
HéLOïSE	HH L OW Z
HéLèNE	HH L N
INNOCENT	IH N AH S AH N T
INèS	IH N Z
IRINA	IH R IY N AH
IRIS	AY R AH S
IRIS(2)	AY R IH S
IRèNE	AH R N
ISABEAU	AY Z AH B OW
ISABELLE	IH Z AH B EH L
ISEULT	AH S UW L T
ISIDORE	IH Z IH D AO R
ISMéRIE	IH Z M R AY
JACINTHE	JH AE S IH N TH
JACQUELINE	JH AE K W AH L IH N
JACQUELINE(2)	JH AE K L IH N
JACQUELINE(3)	JH AE K AH L IH N
JACQUES	ZH AA K
JACQUES(2)	JH AE K
JADE	JH EY D
JANINE,	JH AH N AY N
JAPHET	JH AE F AH T
JASON	JH EY S AH N
JEAN	JH IY N
JEANNE	JH IY N
JEANNEL	JH IY N AH L
JEANNOT	JH IY N AH T
JEHANNE,	JH EH HH AH N
JOACHIM	Y OW AA K IH M
JOACHIM(2)	W AA K IY M
JOANNY	JH OW N IY
JOB	JH AA B
JOB(2)	JH OW B
JOCELYN	JH AO S L IH N
JOCELYNE	JH AO S L IH N
JOHAN	Y OW HH AA N
JONAS	JH OW N AH S
JONATHAN	JH AA N AH TH AH N
JOSEPH	JH OW S AH F
JOSEPH(2)	JH OW Z AH F
JOSSE	JH AA S
JOSSELIN	JH AA S AH L AH N
JOSéPHINE	JH AA S AY N
JOURDAIN	JH AH R D EY N
JOëL	JH AA L
JOëLLE	JH AA L
JUDE	JH UW D
JUDICAëL	JH UW D IH S AH L
JUDITH	JH UW D IH TH
JULES	JH UW L Z
JULIE	JH UW L IY
JULIEN	JH UW L IY AH N
JULIETTE	JH UW L IY EH T
JUSTE	JH AH S T
JUSTIN	JH AH S T AH N
JUSTIN(2)	JH AH S T IH N
JUSTINE	JH AH S T IY N
JéRéMIE	JH R M AY
JéRôME	JH R M
KéVIN	K V IH N
LAMBERT	L AE M B ER T
LANDRY	L AE N D R IY
LAURA	L AO R AH
LAURANE	L AH R EY N
LAURE	L AO R
LAURELINE	L AO R AH L AY N
LAURENCE	L AO R AH N S
LAURENT	L AO R AH N T
LAURIANE	L AO R IY EY N
LAURINE	L AH R AY N
LAURèNE	L AO R N
LAZARE	L AA Z AA R EY
LEU	L UW
LEUFROY	L UW F R OW IY
LIBèRE	L AY B AH R
LIONEL	L AY AH N AH L
LIéTALD	L IH T AH L D
LONGIN	L AO NG IH N
LORRAIN	L AO R EY N
LORRAINE	L ER EY N
LOTHAIRE	L AA TH AH AH R
LOUIS	L UW IH S
LOUIS(2)	L UW IY
LOUP	L UW P
LOïC	L AA K
LUC	L UW K
LUCAS	L UW K AH S
LUCIE	L UW S IY
LUCIEN	L UW S IY EH N
LUCIENNE	L UW S IY EH N
LUCILLE	L UW S IY L
LUDIVINE	L UW D AH V AY N
LUDOLPHE	L UW D OW L F
LUDOVIC	L UW D AH V AH K
LYDIE	L IH D IY
LéA	L AA
LéANDRE	L AE N D AH R
LéNA	L N AA
LéON	L AA N
LéONARD	L AA N AH R D
LéONIE	L OW N IY
LéONNE	L AA N
LéOPOLD	L AA P OW L D
LéOPOLDINE	L AA P OW L D AY N
MACAIRE	M AE K AH AH R
MADELEINE	M AE D AH L EH N
MAGALI	M AE G AH L IY
MAGUELONE	M AE G W AH L OW N
MAHAUT	M AE HH AH T
MALLAURY	M AE L AO R IY
MALO	M AA L OW
MAMERT	M AE M AH R T
MANASSé,	M AA N AH Z
MANON	M AA N AO N
MARC	M AA R K
MARCEAU	M AA R S OW
MARCEL	M AA R S EH L
MARCELIN	M AA R S EH L IH N
MARCELINE	M AA R S AH L AY N
MARGOT	M AA R G OW
MARGUERITE	M AA R G ER IY T
MARIANNE	M AA R IY AE N
MARIE	M ER IY
MARINE	M ER IY N
MARION	M EH R IY AH N
MARIUS	M AA R IY AH S
MARLèNE	M AA R L N
MARTHE	M AA R DH
MARTIAL	M AA R SH AH L
MARTIN	M AA R T AH N
MARTIN(2)	M AA R T IH N
MARTINE	M AA R T IY N
MATHILDE	M AE TH IH L D
MATHILDE(2)	M AH T IH L D
MATHURIN	M AE TH AH R AH N
MATTHIAS	M AH TH AY AH S
MATTHIEU	M AE T TH Y UW
MAUD	M AO D
MAUGIS	M AO JH AH S
MAUREEN	M AO R IY N
MAURICE	M AO R IY S
MAURICE(2)	M AA R IH S
MAURICETTE	M EY Y UH R AH S EH T
MAXENCE	M AE K S AH N S
MAXIME	M AE K S IY M
MAXIMILIEN	M AE K S IY M AY L IY AH N
MAYEUL	M EY IY AH L
MELCHIOR	M EY L CH IY ER
MENCE	M EH N S
MERLIN	M ER L IH N
MICHEL	M IH SH EH L
MICHEL(2)	M IH CH AH L
MICHEL(3)	M AY K AH L
MICHèLE	M IH K L
MIREILLE	M AH R IY L
MIRIAM	M IH R IY AH M
MONIQUE	M OW N IY K
MORGAN	M AO R G AH N
MORGANE	M AO R G EY N
MOïSE	M OW Z
MOïSETTE	M OW Z EH T
MURIEL	M Y UH R IY AH L
MYLèNE	M IH L N
MéDéRIC	M D R IH K
MéGANE	M G EY N
MéLANIE	M L EY N AY
MéLISANDE	M L IH S AH N D
MéLISSA	M L IH S AH
MéLISSANDRE	M L IH S AE N D AH R
MéLODIE	M L OW D AY
MéROVéE	M R OW V
NADINE	N AH D IY N
NADèGE	N AE JH
NARCISSE	N AA R S IH S
NATHALIE	N AE T AH L IY
NATHAN	N EY TH AH N
NATHANAëL	N AE TH AH N AH L
NAUDET	N AO D AH T
NESTOR	N EH S T ER
NICOLAS	N IH K AO L AH S
NICOLE	N IH K OW L
NICéPHORE	N IH K AH R
NINE	N AY N
NORBERT	N AO R B ER T
NORMAND	N AO R M AH N D
NOé	N OW
NOéMIE	N OW M AY
NOëL	N AA L
NOëLLE	N AA L
NéHéMIE	N HH M AY
OCTAVE	AA K T IH V
OCéANE	AH K EY N
ODETTE	OW D EH T
ODILE	OW D AH L
ODILON	AA D AH L AH N
ODON	AA D AH N
OGER	OW JH AH R
OLIVE	AA L AH V
OLIVE(2)	AA L IH V
OLIVIER	OW L IH V IY EY
OLYMPE	AA L AH M P
OMBLINE	AA M B L AY N
OPHéLIE	AA F L AY
ORIANDE	AO R IY AH N D
ORIANE	AO R IY EY N
ORLANE	AO R L EY N
OURY	AW R IY
OXLENE	AA K S L IY N
OZANNE	OW Z AE N
PACôME	P AE K M
PALéMON	P AA M AO N
PARFAIT	P AA R F EY
PASCAL	P AE S K AE L
PASCALE	P AE S K AE L
PATERNE	P AE T AH R N
PATRICE	P AH T R IY S
PAUL	P AO L
PAULE	P AO L
PAULETTE	P AO L EH T
PAULINE	P AO L IY N
PERCEVAL	P ER S EY V AE L
PERRINE	P ER R IY N IY
PHILIBERT	F IH L IH B ER T
PHILIPPE	F IH L IY P EY
PHILIPPINE	F IH L AH P IY N
PHILOMèNE	F IH L AH M
PHILOTHéE	F AH L OW DH
PHILéMON	F IH L M AH N
PIE	P AY
PIERRE	P IY EH R
PIERRICK	P IY R AH K
PRIMEROSE	P R IH M IH R OW S
PRISCILLE,	P R IH S AH L
PROSPER	P R AA S P ER
PRUDENCE	P R UW D AH N S
PULCHéRIE	P UH L K R AY
PéCINE	S AY N
PéLAGIE	P L EY JH AY
PéNéLOPE	N L OW P
PéPIN	P IH N
PéTRONILLE	T R AA N AH L
QUENTIN	K W EH N T IH N
QUENTINE	K W EH N T AY N
QUINTIA	K W IH N CH IY AH
QUIéTA	K W IH T AH
RACHEL	R EY CH AH L
RAOUL	R AA UW L
RAPHAëL	R AE F AH L
RAPHAëLLE	R AE F AH L
RAYMOND	R EY M AH N D
RAYMONDE	R EY M AH N D
REBECCA	R AH B EH K AH
REINE	R EY N
RENAUD	R IH N OW
RENé	R EH N
RENéE	R AH N IY
REYBAUD	R IY Y B AO D
RICHARD	R IH CH ER D
RITA	R IY T AH
ROBERT	R AA B ER T
ROCH	R AA K
RODOLPHE	R AH D OW L F
RODRIGUE	R OW D R IY G
ROGER	R AA JH ER
ROLAND	R OW L AH N D
ROLANDE	R AA L AH N D
ROMAIN	R OW M EY N
ROMANE	R AH M EY N
ROMUALD	R OW M Y UW AA L D
ROMéO	R OW M OW
RONAN	R OW N AH N
ROSALIE	R OW Z AH L IY
ROSE	R OW Z
ROSELIN	R AA S AH L AH N
ROSELINE	R OW Z L AY N
RéGINE	R JH AY N
RéGIS	R JH IH Z
RéJEAN	R JH IY AH N
RéJEANNE	R JH IY N
RéMI	R M IY
SABINE	S AH B IY N
SALOMON	S AE L AH M AH N
SALOMé	S AE L AH M
SAMUEL	S AE M Y UW L
SANDRA	S AE N D R AH
SANDRINE	S AE N D R AY N
SARAH	S EH R AH
SAUVEUR	S AO V AH R
SAVIN	S AE V IH N
SCHOLASTIQUE	S K AH L AE S T AH K
SERGE	S ER JH
SIBYLLE	S IH B AH L
SIDOINE	S AH D OY N
SIGEBERT	S IH JH AH B AH R T
SIGISMOND	S AH JH IH Z M AH N D
SILVèRE,	S IH L V AH R
SIMON	S AY M AH N
SIMONE	S IH M OW N
SIXTE	S IH K S T
SIXTINE	S IH K S T AY N
SOLANGE	S AA L AH N JH
SOLINE	S AH L AY N
SOPHIE	S OW F IY
STANISLAS	S T AE N IH S L AA S
STéPHANE	S T F EY N
STéPHANIE	S T F EY N AY
SUZANNE	S UW Z AE N
SUZON,	S UW Z AH N
SYLVAIN	S IH L V EY N
SYLVESTRE	S IH L V EH S T ER
SYLVIANE	S IH L V IY EY N
SYLVIE	S IH L V IY
SéBASTIEN	S B AE S T IY AH N
SéGOLèNE	S G OW L N
SéRAPHIN	S R AE F AH N
SéVERIN	S V EH R AH N
SéVERINE	S V AH R AY N
TANCRèDE	T AE NG K R D
TANGUY	T AE N G AY
TATIANA	T AE T IY AE N AA
TATIANA(2)	T AE T Y AA N AA
TAURIN	T AO R AH N
THAïS	TH AE Z
THIBAULT	TH IH B OW
THIBERT	TH IH B ER T
THIERRY	TH IH R IY
THOMAS	T AA M AH S
THéODORA	TH AA D AH R AH
THéODORE	TH AA D AH R
THéODOSE	TH AH D OW Z
THéOPHILE	TH AH F AY L
THéOPHRASTE	TH AA F R EY S T
THéRèSE	TH R S
TIMOLéON	T IH M AH L AH N
TIMOTHéE	T AH M OW DH
TIPHAINE	T AH F EY N
TITIEN	T IH T IY AH N
TONNIN	T AA N AH N
TOUSSAINT	T UW S AE N
TRAJAN	T R EY JH AH N
TRISTAN	T R IH S T AE N
TUROLD	T Y AH R OW L D
ULYSSE	Y UW L AH S
URBAIN	ER B EY N
URSULE	AH R ZH UW L
VALENTIN	V AA L EH N T IY N
VALENTINE	V AE L AH N T AY N
VALèRE	V EY L AH R
VALéRIE	V AE L R AY
VALéRY	V AE L R IY
VENANCE	V IY N AH N S
VENCESLAS	V EH N S EH Z L AH Z
VIANNEY	V AY AE N IY
VICTOIRE	V IH K T W AA R
VICTOR	V IH K T ER
VICTORIEN	V IH K T AH R IY AH N
VICTORIN	V IH K T ER IH N
VIGILE	V IH JH AH L
VINCENT	V IH N S EH N T
VINCENT(2)	V IH N S IH N T
VINCIANE	V IH N S IY EY N
VIOLETTE	V IY OW L EH T
VIRGINIE	V ER JH AH N IY
VITAL	V AY T AH L
VIVIANE	V IH V IY EY N
VIVIEN	V IH V IY AH N
VéRONIQUE	V R AA N AH K
WALERAN	W EY L R AE N
WANDRILLE	W AA N D R AH L
XAVIER	Z EY V Y ER
XAVIèRE	Z EY V AY R
XéNOPHON	Z N AA F AH N
YOLANDE	Y OW L AH N D
YSALINE	Y S AH L AY N
YSEULT	Y S UW L T
YVES	IY V
YVETTE	IH V EH T
YVONNE	IH V AA N
ZACHARIE	Z AE CH AH R AY
ZACHé	Z AE CH
ZITA	Z IY T AH
ZOé	Z OW
ZéLIE	Z L AY
ZéPHIRIN	Z F IH R AH N
ÈVE	V IY
ÉDITH	D IH TH
ÉDOUARD	D AW AH R D
ÉLEUTHèRE	L UW TH R
ÉLIA	L AY AH
ÉLIANE	L AY AH N
ÉLIE	L AY
ÉLISABETH	L IH S AH B AH TH
ÉLISE	L AY Z
ÉLISéE	L AY Z
ÉLODIE	L OW D AY
ÉLOïSE	L UW Z
ÉLéONORE	L AA N AH R
ÉMELINE	M AH L AY N
ÉMERIC	M IH ER IH K
ÉMILE	M AY L
ÉMILIE	M AY L IY
ÉMéRANCE	M R AE N S
ÉMéRENCIE	M R EH N S AY
ÉPIPHANE	P AH F EY N
ÉRIC	R IH K
ÉTIENNE	T IY N
ÉVA	V AA
ÉVANGéLINE	V AE N G L AY N
ÉVARISTE	V AH R AY S T
ÉVELYNE	V AH L AY N
ÉVRARD	V R AA R D
